-----アイテム-----

-----Attack-----
動物園->人参->きぐるみ
駅->切符->定期券
消防局->消防車->消化器
警察->手錠->拳銃
電気屋->100万ボルト->電気椅子
美容院->ハサミ->カツラ
神社・寺->お経->装束
銀行->札束->金庫

-----Defense-----
ジム->プロテイン->筋肉
ホームセンター->ハンマー->ヘルメット
弁護士事務所->ガベル->バッジ
学校->給食->体育着
郵便局->切手->郵便受け
ガソリンスタンド->車->ガソリン
空港->ジェット機->パスポート
役所・役場->証明書->スーツ

-----Support-----
映画館->ポップコーン->3Dメガネ
図書館->魔導書->辞書
コンビニ->おにぎり->レジ袋
ホテル->バイキング->ポーター
病院->薬->包帯
レストラン->ハンバーグ->ナイフ
スーパーマーケット->バナナ->カゴ
カフェ->コーヒー->ケーキ

-----Setting-----
同じ場所のキャラ＋アイテムで効果2倍
